................
................
...#........#...
................
.......**.......
.......**.......
................
...#........#...
................
................
