................
................
...*...##...*...
................
...#........#...
...#........#...
................
...*...##...*...
................
................
