................
...........#....
...*............
................
................
..*.....#.......
.............*..
................
...#.......#....
......*.........
